000000000000000001111111111111111111
0000000000000000010000g0000010000111
000000000000000001011111111000110011
000000000000000001000000021111111001
000000000000000001111111111111111101
000000000000000000000g00000000g00001
00000000000g000001111111111111111111
00000000001110000g000000111111100001
100000gg0000000001111110111111000111
000001110000000011111110111111100011
000000000000000111111100111111000111
100000000g00000011111110111111100011
000000000100000001111110000001000111
000000001111111111111110111111100011
000000011111111111111110000000000111
111111111111111111111111111111111111