1111111111
1200g000g1
1100110011
1000000001
10g00g0g11
1011111111
1g00g00001
1111111101
1000g000g1
1011111111
1000000001
10000g0001
1100110001
1000111g01
1000111101
10000000g1
1000000011
100000g001
1000001001
1000g11001
1g00111001
1110000g01
1000111101
1000g000g1
1111111111