1111111111111111111111111111111111111111111111111111111111111111111111
10000000000000000000000000001000000000000000000000000000000g0000000001
100000000000000000000000000000000000000000g00ggg000000g000111000000001
100000000000000000000000g000ggg000000g00011100000g0001110000000ggg0001
10000000000000000000g01111000ggg0000111000000000111000000000g000ggg001
10000000000000000g011110000010ggg000000000000g000000000g000111000ggg01
10000000000000g0111100000000100111100000g000111000g000111000000000ggg1
10000gg0000g01111000000000001000000g00011100000001110000000g0000111001
1000011100111100000000000000100000111000100000000010000000111000000021
1111111111111111111111111111111111111111111111111111111111111111111111