1000000000000000000000000000000000000000000000000000000000000000000000000000000000000000000000000000000000000000000000000
1000000000000000000000000000000000000000000000000000000000000000000000000000000000000000000000000000000000000000000000000
1000000000000000000000000000000000000000000000000000000000000000000000000000000000000000000000000000000000000000000000000
1000000000000000000000000000000000000000000000000000000000000000000000000000000000000000000000000000000000000000000000000
1000000000000000000000000000000000000000000000000000000000000000000000000000000000000000000000000000000000000000000000000
100000000000000g0000000000000000000000000000000g000000000000000000000000000g00000000000000000000000000g000000000000000000
1000000000000001000000000000000000g00000000000010000000000000000000000000001000000000000000000000000001000000000000100000
1000000000000001000000001000000000100000000100010000000000000000000000100001000000000000000000000000001000010001000100000
100001000g000111000g000110000000001000000001000000000000g000000100000010000100000000g000000000010000001000010001000g00002
1111111111111111111111111111111111111111111111111111111111111111111111111111111111111111111111111111111111111111111111111