11111111111111111111111111111111111
000000000000000g100000gg10000000011
01111111111100011011000g1000gg00011 
000000000001110010g110001011111g011
111111111101110010111100101gg011011
11112gggg0011100g00gg110g0100000g11 
11111111111111111111111111100111111
0000gg000000000000000000000gg000001
gg0011000000g00000000000011111100g1
1100000000111110000000g00000000g011
0000gg00000g1g0000000111000g0011111
00111111000g1g000000110000111000001
0000000000111100g001100000000000001
0000000g011111111111111111111111111                       
11100011111111111111111111111111111
11111111111111111111111111111111111
